6 7
4 4 4 4 4 4 4
4 1 1 4 5 5 4
4 4 1 9 4 4 5
4 8 4 6 4 0 4
4 4 8 4 4 2 2
4 4 4 4 9 4 2
2 2
2 3
5 5