9 13
4 5 2 5 2 7 9 5 8 2 5 0 7 
0 2 2 10 2 3 10 2 7 4 11 3 9 
9 0 8 4 4 1 9 2 7 7 5 6 6 
5 5 3 4 5 0 8 2 9 6 2 8 1 
10 10 9 10 8 10 2 10 2 7 10 4 6 
3 10 2 10 5 11 5 10 2 6 7 6 11 
10 6 8 8 5 9 7 4 1 7 6 0 0 
7 9 3 6 5 3 3 4 5 9 6 8 1 
6 3 5 2 8 6 6 10 5 7 7 10 11 
3
4 1 1 4 1 3
4 2 5 2 3 3
4 0 1 0 2 2